11111111111111111111
11111111111111111111
11111111111111111111
11111111111111111111
11110000000000P11111
11110000000000011111
11100000000000011111
11100000222000011111
11110000033300000011
11111000000000000111
11111111111111111111
11111111111111111111
11111111111111111111
11111111111111111111
11111111111111111111
11111111111111111111
11111111111111111111
11111111111111111111
11111111111111111111
11111111111111111111
